1111111111111111111111111
1C00E0C00000000000B00C001
100C0000111B0011000000001
100111000000C0000000000C1
10P000000111000000C000E01
10B0000001000000C0100C001
100C000011100011000B00011
1C0010C00000100C00000C001
1C0000C00000000100C011101
100C0B001110001100C00C001
100111000000C000B00C11001
1B0E000111000000000010001
10C0010000C0C11100C000C01
1111111111111111111111111