1111111111111
1C01000C000C1
100C011111001
1P001100BC001
10BC000E000C1
1111111111111
