11111111111111111111111
10C0010000001110000C001
1000000000001C100000001
1E000100000000000000001
1110010000110000101C011
10000100101100111110011
1P000000000000100000001
1000000C000000000010C01
10C00100000001000010001
10000C1100001110000E001
10E001000000C110000C001
11111111111111111111111