11111111111111111111111111111111111
10C000000000000E000000000C000000011
10100101001000001010010000000101011
1000P000C00000C00000000000000000111
11111111111111111111111111111111111
11111111111111111111111111111111111