1111111111111
1C01000C000C1
100C011111001
1P0011000C001
100C000E000C1
1111111111111